..#....#..
.#........
......#...
...#......
.#...##.#.
..#...#...
.......#.#
..#.....#.
....#.#...
..#.#..##.
==========================
..#....#..
.#........
......#...
...#......
.#...##.#.
..#...#...
.......#.#
..#.....#.
....#.#...
..#.#..##.
==========================
..#....#..
.#........
......#...
...#......
.#...##.#.
..#...#...
.......#.#
..#.....#.
....#.#...
..#.#..##.
==========================
..#....#..
.#........
......#...
...#......
.#...##.#.
..#...#...
.......#.#
..#.....#.
....#.#...
..#.#..##.
==========================
..#....#..
.#........
......#...
...#......
.#...##.#.
..#...#...
.......#.#
..#.....#.
....#.#...
..#.#..##.
==========================
